11111111111111
1E00C00C000001
10100100000101
10101100101001
10P00C000000C1
10000001000001
10001000000001
10011100000001
11111111111111